{
    "metadata": {
        "tileset": "Indoors",
        "width": 10,
        "height": 10
    },
    "events": [

    ],
    "map": [
        "00","01","02","00","00","00","00","00","00","00",
        "03","04","05","00","00","00","00","00","00","00",
        "24","00","00","00","00","00","00","00","00","00",
        "00","00","00","00","00","00","00","00","00","00",
        "00","00","00","00","00","00","00","00","00","00",
        "00","00","00","00","00","00","00","00","00","00",
        "00","00","00","00","00","00","00","00","00","00",
        "00","00","00","00","00","00","00","00","00","00",
        "00","00","00","00","00","00","00","00","00","00",
        "00","00","00","00","00","00","00","00","00","00"
    ]
}